*******
*xx3xx*
*xx*xx*
* 111 *
*  2  *
* 111 *
*  *p *
*******
