******
*    *
* 1 p*
**b  *
* c **
* a *
* b *
* x *
*****
