 ******
 *    **
**x**1 *
* xx1  *
*  *1  *
*  p ***
******
