       *******
****   *     *
*  ***** * * *
*     x x x x*
*  *  x*x*x*x*
**  * ** * * *
*** *    * * *
*   *   ** * *
*   ***    * *
** 12 *    *2*
 *    ***    *
 **  31 *   **
  **    ***p*
 * **  12   *
  * **    3 *
   * *  *****
     ****
