********
***  ***
*  1   *
* 2 2  *
*  1 1 *
* 1321 *  ******
** *p******    ***
** xxxxxxxxx *   ***
***********    *   *
          * *    * *
          *   *    *
          **    * **
           * *    *
           *   * **
           ***   *
             *****
