*****
*   *
* 1p* ***
* 23* *x*
*** ***x*
 **    x*
 *   *  *
 *   ****
 *****
