******      ****   
*    ********  ****
*   1*   *  1  *  *
*  1  1   1p* 1 1 *
**1 1    *  * 1   *
*  1  **********  *
* *   *xxxxxxx* 2**
* **  *xxxxxxx*  * 
* *   3 xxxxxxx1 * 
* * 1 *xxxx xx*  * 
*  1 1****3**** 2* 
* 1   *** 1   1  **
* 1     1 1  1    *
** ****** 1 ***** *
*         *       *
*******************
