 ****
 **  *
 * p1*
 **2 **
 ** 3 *
 *x2  *
 *xxax*
 ******
