  ******
  *    *
***113 *
*p 1xx *
* 2xxx**
****  *
   ****
