******
*    *
* 232**
*  *xx***
**  xx1 *
 * p    *
 ********
