 *****
 * p ***
** *3  *
* bx x *
*  11 **
*** *x*
  *   *
  *****
