  ****
  *  *
***1 **
*  a p*
*  a  *
*  b **
***c *
  *x**
  ***
