*****
*   *****
* * *   *
* 1   2 *
*xx*3*2**
*xp1   *
*xx  ***
******
