 ****
 *p ***
 * 2  *
*** * **
*x* *  *
*x1  * *
*x   3 *
********
