  *****
***  p*
*  2x **
*  x2x *
*** c2 *
  *   **
  *****
