  ****
  *xx*
 ** x**
 *  2x*
** 1  **
*  *21 *
*  p   *
********
