********
*  *   *
*p2xx1 *
* 2xc **
* 2xx1 *
*  *   *
********
